"bS" = (/turf/simulated/floor/tiled/monotile,/area/crew_quarters/recreation)
"bZ" = (/obj/machinery/door/airlock/external{name = "Dock Airlock Internal"},/turf/simulated/floor/tiled/steel_grid,/area/ship/scrap/dock)
"dy" = (/obj/machinery/door/airlock/multi_tile/glass/civilian,/turf/simulated/floor/tiled/monotile,/area/crew_quarters/sleep/cryo)
"et" = (/turf/simulated/wall/prepainted,/area/crew_quarters/galley)
"fe" = (/obj/effect/landmark{name = "JoinLateCryo"},/turf/simulated/floor/tiled/old_tile,/area/crew_quarters/sleep/cryo)
"fA" = (/turf/simulated/floor/tiled/monotile,/area/hallway/primary/thirddeck/center)
"in" = (/obj/structure/hygiene/shower{dir = 4},/turf/simulated/floor/tiled/monotile,/area/map_template/colony/bathroom)
"iX" = (/turf/simulated/floor/tiled/white,/area/crew_quarters/galleybackroom)
"ja" = (/turf/simulated/floor/tiled/monotile,/area/crew_quarters/sleep/cryo)
"jh" = (/turf/simulated/wall/prepainted,/area/crew_quarters/mess)
"jm" = (/obj/effect/wallframe_spawn,/turf/simulated/wall/r_wall/rglass_wall,/area/engineering/engineering_bay)
"jA" = (/obj/effect/wallframe_spawn,/turf/simulated/wall/r_wall/rglass_wall,/area/hallway/primary/thirddeck/center)
"kR" = (/obj/machinery/door/airlock/glass/command,/turf/simulated/floor/tiled/monotile,/area/hallway/primary/thirddeck/center)
"lj" = (/turf/simulated/wall/prepainted,/area/engineering/engineering_bay)
"ln" = (/obj/machinery/door/airlock/glass/civilian,/turf/simulated/floor/tiled/monotile,/area/crew_quarters/mess)
"lQ" = (/obj/machinery/door/airlock/glass/civilian,/turf/simulated/floor/tiled/monotile,/area/crew_quarters/sleep/bunk)
"mJ" = (/obj/machinery/door/airlock/civilian,/turf/simulated/floor/tiled/white,/area/crew_quarters/galley)
"nu" = (/turf/simulated/wall/prepainted,/area/crew_quarters/sleep/cryo)
"nv" = (/obj/effect/wallframe_spawn,/turf/simulated/wall/prepainted,/area/crew_quarters/sleep/cryo)
"ot" = (/obj/machinery/door/blast/shutters,/obj/structure/table/marble,/turf/simulated/floor/tiled/white,/area/crew_quarters/galley)
"oD" = (/turf/simulated/wall/prepainted,/area/map_template/mininghome_bathroom)
"pR" = (/obj/machinery/door/blast/shutters,/obj/structure/table/marble,/obj/item/material/bell,/turf/simulated/floor/tiled/white,/area/crew_quarters/galley)
"qg" = (/turf/simulated/floor/tiled/white,/area/crew_quarters/mess)
"rT" = (/obj/machinery/door/unpowered/simple/plastic,/turf/simulated/floor/tiled/monotile,/area/map_template/colony/bathroom)
"rZ" = (/turf/simulated/wall/prepainted,/area/ship/scrap/dock)
"uc" = (/obj/machinery/door/airlock/glass/civilian,/turf/simulated/floor/tiled/monotile,/area/crew_quarters/recreation)
"vZ" = (/turf/space,/area/space)
"wq" = (/turf/simulated/floor/tiled/monotile,/area/engineering/engineering_bay)
"xU" = (/obj/machinery/door/airlock/glass/engineering,/turf/simulated/floor/tiled/monotile,/area/engineering/engineering_bay)
"Ac" = (/turf/simulated/floor/tiled/old_tile,/area/crew_quarters/sleep/cryo)
"DX" = (/turf/simulated/wall/prepainted,/area/hallway/primary/thirddeck/center)
"Ee" = (/obj/structure/hygiene/toilet{dir = 4},/turf/simulated/floor/tiled/monotile,/area/map_template/mininghome_bathroom)
"Gu" = (/turf/simulated/floor/tiled/monotile,/area/map_template/mininghome_bathroom)
"Iz" = (/turf/simulated/floor/tiled/monotile,/area/crew_quarters/sleep/bunk)
"JL" = (/obj/machinery/door/airlock/external{name = "Dock Airlock External"},/turf/simulated/floor/tiled/steel_grid,/area/ship/scrap/dock)
"Kv" = (/obj/machinery/door/unpowered/simple/plastic,/turf/simulated/floor/tiled/monotile,/area/map_template/mininghome_bathroom)
"Nn" = (/turf/simulated/wall/prepainted,/area/map_template/colony/bathroom)
"Pj" = (/turf/simulated/wall/prepainted,/area/security/habcheck)
"Rf" = (/turf/simulated/wall/r_wall/hull,/area/ship/scrap/dock)
"Tn" = (/turf/simulated/wall/prepainted,/area/crew_quarters/recreation)
"Tx" = (/turf/simulated/floor/tiled/monotile,/area/map_template/colony/bathroom)
"Uu" = (/turf/simulated/wall/prepainted,/area/crew_quarters/sleep/bunk)
"UY" = (/turf/simulated/floor/tiled/dark/monotile,/area/security/habcheck)
"Ve" = (/turf/simulated/floor/tiled/steel_ridged,/area/ship/scrap/dock)
"Vz" = (/obj/machinery/cryopod,/turf/simulated/floor/tiled/old_tile,/area/crew_quarters/sleep/cryo)
"Wn" = (/obj/machinery/door/airlock/glass/security,/turf/simulated/wall/prepainted,/area/security/habcheck)
"WC" = (/turf/simulated/floor/tiled/steel_grid,/area/ship/scrap/dock)
"Zm" = (/turf/simulated/floor/tiled/white,/area/crew_quarters/galley)
"ZG" = (/turf/simulated/wall/prepainted,/area/crew_quarters/galleybackroom)

(1,1,1) = {"
vZvZvZvZvZvZvZvZvZvZvZvZvZvZvZvZvZvZvZvZvZvZvZvZvZvZvZvZvZvZvZvZvZvZvZvZvZvZvZvZvZvZvZvZvZvZvZvZvZvZvZvZvZvZvZvZvZvZvZvZvZvZvZvZvZvZvZvZvZvZ
vZvZvZvZvZvZvZvZvZvZvZvZvZvZvZvZvZvZvZvZvZvZvZvZvZvZvZvZvZvZvZvZvZvZvZvZvZvZvZvZvZvZvZvZvZvZvZvZvZvZvZvZvZvZvZvZvZvZvZvZvZvZvZvZvZvZvZvZvZvZ
vZvZvZvZvZvZvZvZvZvZvZvZvZvZvZvZvZvZvZvZvZvZvZvZvZvZvZvZvZvZvZvZvZvZvZvZvZvZvZvZvZvZvZvZvZvZvZvZvZvZvZvZvZvZvZvZvZvZvZvZvZvZvZvZvZvZvZvZvZvZ
vZvZvZvZvZvZvZvZvZvZvZvZvZvZvZvZvZvZvZvZvZvZvZvZvZvZvZvZvZvZvZvZvZvZvZvZvZvZvZvZvZvZvZvZvZvZvZvZvZvZvZvZvZvZvZvZvZvZvZvZvZvZvZvZvZvZvZvZvZvZ
vZvZvZvZvZvZvZvZvZvZvZvZvZvZvZvZvZvZvZvZvZvZvZvZvZvZvZvZvZvZvZvZvZvZvZvZvZvZvZvZvZvZvZvZvZvZvZvZvZvZvZvZvZvZvZvZvZvZvZvZvZvZvZvZvZvZvZvZvZvZ
vZvZvZvZvZvZvZvZvZvZvZvZvZvZvZvZvZvZvZvZvZvZvZvZvZvZvZvZvZvZvZvZvZvZvZvZvZvZvZvZvZvZvZvZvZvZvZvZvZvZvZvZvZvZvZvZvZvZvZvZvZvZvZvZvZvZvZvZvZvZ
vZvZvZvZvZvZvZvZvZvZvZvZvZvZvZvZvZvZvZvZvZvZvZvZvZvZvZvZvZvZvZvZvZvZvZvZvZvZvZvZvZvZvZvZvZvZvZvZvZvZvZvZvZvZvZvZvZvZvZvZvZvZvZvZvZvZvZvZvZvZ
vZvZvZvZvZvZvZvZvZvZvZvZvZvZvZvZvZvZvZvZvZvZvZvZvZvZvZvZvZvZvZvZvZvZvZvZvZvZvZvZvZvZvZvZvZvZvZvZvZvZvZvZvZvZvZvZvZvZvZvZvZvZvZvZvZvZvZvZvZvZ
vZvZvZvZvZvZvZvZvZvZvZvZvZvZvZvZvZvZvZvZvZvZvZvZvZvZvZvZvZvZvZvZvZvZvZvZvZvZvZvZvZvZvZvZvZvZvZvZvZvZvZvZvZvZvZvZvZvZvZvZvZvZvZvZvZvZvZvZvZvZ
vZvZvZvZvZvZvZvZvZvZvZvZvZvZvZvZvZvZvZvZvZvZvZvZvZvZvZvZvZvZvZvZvZvZvZvZvZvZvZvZvZvZvZvZvZvZvZvZvZvZvZvZvZvZvZvZvZvZvZvZvZvZvZvZvZvZvZvZvZvZ
vZvZvZvZvZvZvZvZvZvZvZvZvZvZvZvZvZvZvZvZvZvZvZvZvZvZvZvZvZvZvZvZvZvZvZvZvZvZvZvZvZvZvZvZvZvZvZvZvZvZvZvZvZvZvZvZvZvZvZvZvZvZvZvZvZvZvZvZvZvZ
vZvZvZvZvZvZvZvZvZvZvZvZvZvZvZvZvZvZvZvZvZvZvZvZvZvZvZvZvZvZvZvZvZvZvZvZvZvZvZvZvZvZvZvZvZvZvZvZvZvZvZvZvZvZvZvZvZvZvZvZvZvZvZvZvZvZvZvZvZvZ
vZvZvZvZvZvZvZvZvZvZvZvZvZvZvZvZvZvZvZvZvZvZvZvZvZvZvZvZvZvZvZvZvZvZvZvZvZvZvZvZvZvZvZvZvZvZvZvZvZvZvZvZvZvZvZvZvZvZvZvZvZvZvZvZvZvZvZvZvZvZ
vZvZvZvZvZvZvZvZvZvZvZvZvZvZvZvZvZvZvZvZvZvZvZvZvZvZvZvZvZvZvZvZvZvZvZvZvZvZvZvZvZvZvZvZvZvZvZvZvZvZvZvZvZvZvZvZvZvZvZvZvZvZvZvZvZvZvZvZvZvZ
vZvZvZvZvZvZvZvZvZvZvZvZvZvZvZvZvZvZvZvZvZvZvZvZvZvZvZvZvZvZvZvZvZvZvZvZvZvZvZvZvZvZvZvZvZvZvZvZvZvZvZvZvZvZvZvZvZvZvZvZvZvZvZvZvZvZvZvZvZvZ
vZvZvZvZvZvZvZvZvZvZvZvZvZvZvZvZvZvZvZvZvZvZvZvZvZvZvZvZvZvZvZvZvZvZvZvZvZvZvZvZvZvZvZvZvZvZvZvZvZvZvZvZvZvZvZvZvZvZvZvZvZvZvZvZvZvZvZvZvZvZ
vZvZvZvZvZvZvZvZvZvZvZvZvZvZvZvZvZvZvZvZvZvZvZvZvZvZvZvZvZvZvZvZvZvZvZvZvZvZvZvZvZvZvZvZvZvZvZvZvZvZvZvZvZvZvZvZvZvZvZvZvZvZvZvZvZvZvZvZvZvZ
vZvZvZvZvZvZvZvZvZvZvZvZvZvZvZvZvZvZvZvZvZvZvZvZvZvZvZvZvZvZvZvZvZvZvZvZvZvZvZvZvZvZvZvZvZvZvZvZvZvZvZvZvZvZvZvZvZvZvZvZvZvZvZvZvZvZvZvZvZvZ
vZvZvZvZvZvZvZvZvZvZvZvZvZvZvZvZvZvZvZvZvZvZvZvZvZvZvZvZvZvZvZvZvZvZvZvZvZvZvZvZvZvZvZvZvZvZvZvZvZvZvZvZvZvZvZvZvZvZvZvZvZvZvZvZvZvZvZvZvZvZ
vZvZvZvZvZvZvZvZvZvZvZvZvZvZvZvZvZvZvZvZvZvZvZvZvZvZvZvZvZvZvZvZvZvZvZvZvZvZvZvZvZvZvZvZvZvZvZvZvZvZvZvZvZvZvZvZvZvZvZvZvZvZvZvZvZvZvZvZvZvZ
vZvZvZvZvZvZvZvZvZvZvZvZvZvZvZvZvZvZvZvZvZvZvZvZvZvZvZvZvZvZvZvZvZvZvZvZvZvZvZvZvZvZvZvZvZvZvZvZvZvZvZvZvZvZvZvZvZvZvZvZvZvZvZvZvZvZvZvZvZvZ
vZvZvZvZvZvZvZvZvZvZvZvZvZvZvZvZvZvZvZvZvZvZvZvZvZvZvZvZvZvZvZvZvZvZvZvZvZvZvZvZvZvZvZvZvZvZvZvZvZvZvZvZvZvZvZvZvZvZvZvZvZvZvZvZvZvZvZvZvZvZ
vZvZvZvZvZvZvZvZvZvZvZvZvZvZvZvZvZvZvZvZvZvZvZvZvZvZvZvZvZvZvZvZvZvZvZvZvZvZvZvZvZvZvZvZvZvZvZvZvZvZvZvZvZvZvZvZvZvZvZvZvZvZvZvZvZvZvZvZvZvZ
vZvZvZvZvZvZvZvZvZvZvZvZvZvZvZvZvZvZvZvZvZvZvZvZvZvZvZvZvZvZvZvZvZvZvZvZvZvZvZvZvZvZvZvZvZvZvZvZvZvZvZvZvZvZvZvZvZvZvZvZvZvZvZvZvZvZvZvZvZvZ
vZvZvZvZvZvZvZvZvZvZvZvZvZvZvZvZvZvZvZvZvZvZvZvZvZvZvZvZvZvZvZvZvZljljljljvZvZvZvZvZvZvZvZvZvZvZvZvZvZvZvZvZvZvZvZvZvZvZvZvZvZvZvZvZvZvZvZvZ
vZvZvZvZvZvZvZvZvZvZvZvZvZvZvZvZvZvZvZvZvZvZvZvZvZvZvZvZvZvZvZvZljljwqwqljljvZvZvZvZvZvZvZvZvZvZvZvZvZvZvZvZvZvZvZvZvZvZvZvZvZvZvZvZvZvZvZvZ
vZvZvZvZvZvZvZvZvZvZvZvZvZvZvZvZvZvZvZvZvZvZvZvZvZvZvZvZvZvZvZljljwqwqwqwqljljvZvZvZvZvZvZvZvZvZvZvZvZvZvZvZvZvZvZvZvZvZvZvZvZvZvZvZvZvZvZvZ
vZvZvZvZvZvZvZvZvZvZvZvZvZvZvZvZvZvZvZvZvZvZvZvZvZvZvZvZvZljljljwqwqwqwqwqwqljljljvZvZvZvZvZvZvZvZvZvZvZvZvZvZvZvZvZvZvZvZvZvZvZvZvZvZvZvZvZ
vZvZvZvZvZvZvZvZvZvZvZvZvZvZvZvZvZvZvZvZvZvZvZvZvZvZvZljljljwqwqwqwqwqwqwqwqwqwqljljljvZvZvZvZvZvZvZvZvZvZvZvZvZvZvZvZvZvZvZvZvZvZvZvZvZvZvZ
vZvZvZvZvZvZvZvZvZvZvZvZvZvZvZvZvZvZvZvZvZvZvZvZvZljljljwqwqwqwqwqwqwqwqwqwqwqwqwqNnNnNnNnvZvZvZvZvZvZvZvZvZvZvZvZvZvZvZvZvZvZvZvZvZvZvZvZvZ
vZvZvZvZvZvZvZvZvZvZvZvZvZvZvZvZvZvZvZvZvZvZvZvZvZljwqwqwqwqwqwqwqwqwqwqwqwqwqwqwqNninTxNnvZvZvZvZvZvZvZvZvZvZvZvZvZvZvZvZvZvZvZvZvZvZvZvZvZ
vZvZvZvZvZvZvZvZvZvZvZvZvZvZvZvZvZvZvZvZvZvZvZvZvZljwqwqwqwqwqwqwqwqwqwqwqoDoDoDoDNninTxNnvZvZvZvZvZvZvZvZvZvZvZvZvZvZvZvZvZvZvZvZvZvZvZvZvZ
vZvZvZvZvZvZvZvZvZvZvZvZvZvZvZvZvZvZvZvZvZvZvZvZvZljwqwqwqwqwqwqwqwqwqwqwqoDEeKvGuNninTxNnvZvZvZvZvZvZvZvZvZvZvZvZvZvZvZvZvZvZvZvZvZvZvZvZvZ
vZvZvZvZvZvZvZvZvZvZvZvZvZvZvZvZvZvZvZvZvZvZvZvZvZljwqwqwqwqwqwqwqljxUjmxUoDoDoDGuNninTxNnvZvZvZvZvZvZvZvZvZvZvZvZvZvZvZvZvZvZvZvZvZvZvZvZvZ
vZvZvZvZvZvZvZvZvZvZvZvZvZvZvZvZvZvZvZvZvZvZvZvZvZljwqwqwqwqwqwqwqljfAfAfAoDEeKvGuNninTxNnvZvZvZvZvZvZvZvZvZvZvZvZvZvZvZvZvZvZvZvZvZvZvZvZvZ
vZvZvZvZvZvZvZvZvZvZvZvZvZvZvZvZvZvZvZvZvZvZvZvZvZljwqwqwqwqwqwqwqljfAfAfAoDoDoDGuNnNnrTNnvZvZvZvZvZvZvZvZvZvZvZvZvZvZvZvZvZvZvZvZvZvZvZvZvZ
vZvZvZvZvZvZvZvZvZvZvZvZvZvZvZvZvZvZvZvZvZvZvZvZvZljljljljljljljljljfAfAfAoDEeKvGuGuGuGuoDvZvZvZvZvZvZvZvZvZvZvZvZvZvZvZvZvZvZvZvZvZvZvZvZvZ
vZvZvZvZvZvZvZvZvZvZvZvZvZvZvZvZvZvZvZvZvZvZvZvZvZDXfAfAfAfAfAfAfADXfAfAfAUuUuUuUulQUuUuUuvZvZvZvZvZvZvZvZvZvZvZvZvZvZvZvZvZvZvZvZvZvZvZvZvZ
vZvZvZvZvZvZvZvZvZvZvZvZvZvZvZvZvZvZvZvZvZvZvZvZvZDXfAfAfAfAfAfAfADXfAfAfAUuIzIzIzIzIzIzUuvZvZvZvZvZvZvZvZvZvZvZvZvZvZvZvZvZvZvZvZvZvZvZvZvZ
vZvZvZvZvZvZvZvZvZvZvZvZvZvZvZvZvZvZvZvZvZvZvZvZvZDXfAfAfAfAfAfAfAfAfAfAfAUuIzIzIzIzIzIzUuvZvZvZvZvZvZvZvZvZvZvZvZvZvZvZvZvZvZvZvZvZvZvZvZvZ
vZvZvZvZvZvZvZvZvZvZvZvZvZvZvZvZvZvZvZvZvZvZvZvZvZDXfAfAfAfAfAfAfAfAfAfAfAlQIzIzIzIzIzIzUuvZvZvZvZvZvZvZvZvZvZvZvZvZvZvZvZvZvZvZvZvZvZvZvZvZ
vZvZvZvZvZvZvZvZvZvZvZvZvZvZvZvZvZvZvZvZvZvZvZvZvZDXfAfAfAfAfAfAfAfAfAfAfAUuIzIzIzIzIzIzUuvZvZvZvZvZvZvZvZvZvZvZvZvZvZvZvZvZvZvZvZvZvZvZvZvZ
vZvZvZvZvZvZvZvZvZvZvZvZvZvZvZvZvZvZvZvZvZvZvZvZvZDXfAfAfAfAfAfAfAfAfAfAfAUuIzIzIzIzIzIzUuvZvZvZvZvZvZvZvZvZvZvZvZvZvZvZvZvZvZvZvZvZvZvZvZvZ
vZvZvZvZvZvZvZvZvZvZvZvZvZvZvZvZvZvZvZvZvZvZvZvZvZjhjhjhjhjhjhjhjhjhfAfAfATnTnTnTnucTnTnTnvZvZvZvZvZvZvZvZvZvZvZvZvZvZvZvZvZvZvZvZvZvZvZvZvZ
vZvZvZvZvZvZvZvZvZvZvZvZvZvZvZvZvZvZvZvZvZvZvZvZvZjhqgqgqgqgqgqgqgjhfAfAfATnbSbSbSbSbSbSTnvZvZvZvZvZvZvZvZvZvZvZvZvZvZvZvZvZvZvZvZvZvZvZvZvZ
vZvZvZvZvZvZvZvZvZvZvZvZvZvZvZvZvZvZvZvZvZvZvZvZvZjhqgqgqgqgqgqgqgjhfAfAfATnbSbSbSbSbSbSTnvZvZvZvZvZvZvZvZvZvZvZvZvZvZvZvZvZvZvZvZvZvZvZvZvZ
vZvZvZvZvZvZvZvZvZvZvZvZvZvZvZvZvZvZvZvZvZvZvZvZvZjhqgqgqgqgqgqgqgjhfAfAfATnbSbSbSbSbSbSTnvZvZvZvZvZvZvZvZvZvZvZvZvZvZvZvZvZvZvZvZvZvZvZvZvZ
vZvZvZvZvZvZvZvZvZvZvZvZvZvZvZvZvZvZvZvZvZvZvZvZvZjhqgqgqgqgqgqgqglnfAfAfATnbSbSbSbSbSbSTnvZvZvZvZvZvZvZvZvZvZvZvZvZvZvZvZvZvZvZvZvZvZvZvZvZ
vZvZvZvZvZvZvZvZvZvZvZvZvZvZvZvZvZvZvZvZvZvZvZvZvZjhqgqgqgqgqgqgqgjhfAfAfATnbSbSbSbSbSbSTnvZvZvZvZvZvZvZvZvZvZvZvZvZvZvZvZvZvZvZvZvZvZvZvZvZ
vZvZvZvZvZvZvZvZvZvZvZvZvZvZvZvZvZvZvZvZvZvZvZvZvZjhqgqgqgqgqgqgqglnfAfAfATnbSbSbSbSbSbSTnvZvZvZvZvZvZvZvZvZvZvZvZvZvZvZvZvZvZvZvZvZvZvZvZvZ
vZvZvZvZvZvZvZvZvZvZvZvZvZvZvZvZvZvZvZvZvZvZvZvZvZjhqgqgqgqgqgqgqgjhfAfAfATnbSbSbSbSbSbSTnvZvZvZvZvZvZvZvZvZvZvZvZvZvZvZvZvZvZvZvZvZvZvZvZvZ
vZvZvZvZvZvZvZvZvZvZvZvZvZvZvZvZvZvZvZvZvZvZvZvZvZjhqgqgqgqgqgqgqglnfAfAfATnTnucTnucTnTnTnvZvZvZvZvZvZvZvZvZvZvZvZvZvZvZvZvZvZvZvZvZvZvZvZvZ
vZvZvZvZvZvZvZvZvZvZvZvZvZvZvZvZvZvZvZvZvZvZvZvZvZjhqgqgqgqgqgqgqgjhfAfAfAfAfAfAfAfAfAfADXvZvZvZvZvZvZvZvZvZvZvZvZvZvZvZvZvZvZvZvZvZvZvZvZvZ
vZvZvZvZvZvZvZvZvZvZvZvZvZvZvZvZvZvZvZvZvZvZvZvZvZjhqgqgqgqgqgqgqgjhfAfAfAfAfAfAfAfAfAfADXvZvZvZvZvZvZvZvZvZvZvZvZvZvZvZvZvZvZvZvZvZvZvZvZvZ
vZvZvZvZvZvZvZvZvZvZvZvZvZvZvZvZvZvZvZvZvZvZvZvZvZetotpRmJPjPjPjPjPjfAfAfAnunvnvdyjanvnvnuvZvZvZvZvZvZvZvZvZvZvZvZvZvZvZvZvZvZvZvZvZvZvZvZvZ
vZvZvZvZvZvZvZvZvZvZvZvZvZvZvZvZvZvZvZvZvZvZvZvZvZetZmZmZmPjUYUYUYWnfAfAfAnuAcAcAcAcAcAcnuvZvZvZvZvZvZvZvZvZvZvZvZvZvZvZvZvZvZvZvZvZvZvZvZvZ
vZvZvZvZvZvZvZvZvZvZvZvZvZvZvZvZvZvZvZvZvZvZvZvZvZetZmZmZmPjUYUYUYPjfAfAfAnuAcAcAcAcAcAcnuvZvZvZvZvZvZvZvZvZvZvZvZvZvZvZvZvZvZvZvZvZvZvZvZvZ
vZvZvZvZvZvZvZvZvZvZvZvZvZvZvZvZvZvZvZvZvZvZvZvZvZetZmZmZmPjUYUYUYPjfAfAfAnuAcAcAcAcAcAcnuvZvZvZvZvZvZvZvZvZvZvZvZvZvZvZvZvZvZvZvZvZvZvZvZvZ
vZvZvZvZvZvZvZvZvZvZvZvZvZvZvZvZvZvZvZvZvZvZvZvZvZetZmZmZmPjUYUYUYPjfAfAfAnuAcAcAcAcAcAcnuvZvZvZvZvZvZvZvZvZvZvZvZvZvZvZvZvZvZvZvZvZvZvZvZvZ
vZvZvZvZvZvZvZvZvZvZvZvZvZvZvZvZvZvZvZvZvZvZvZvZvZetZmZmZmPjPjPjPjPjfAfAfAnuAcAcAcAcAcAcnuvZvZvZvZvZvZvZvZvZvZvZvZvZvZvZvZvZvZvZvZvZvZvZvZvZ
vZvZvZvZvZvZvZvZvZvZvZvZvZvZvZvZvZvZvZvZvZvZvZvZvZetetetmJDXfAfAfADXfAfAfAnuAcAcAcAcAcAcnuvZvZvZvZvZvZvZvZvZvZvZvZvZvZvZvZvZvZvZvZvZvZvZvZvZ
vZvZvZvZvZvZvZvZvZvZvZvZvZvZvZvZvZvZvZvZvZvZvZvZvZZGiXiXiXDXfAfAfADXfAfAfAnuAcfeVzAcfeVznuvZvZvZvZvZvZvZvZvZvZvZvZvZvZvZvZvZvZvZvZvZvZvZvZvZ
vZvZvZvZvZvZvZvZvZvZvZvZvZvZvZvZvZvZvZvZvZvZvZvZvZZGiXiXiXDXfAfAfADXfAfAfAnuAcfeVzAcfeVznuvZvZvZvZvZvZvZvZvZvZvZvZvZvZvZvZvZvZvZvZvZvZvZvZvZ
vZvZvZvZvZvZvZvZvZvZvZvZvZvZvZvZvZvZvZvZvZvZvZvZvZZGiXiXiXDXfAfAfAfAfAfAfAnuAcfeVzAcfeVznuvZvZvZvZvZvZvZvZvZvZvZvZvZvZvZvZvZvZvZvZvZvZvZvZvZ
vZvZvZvZvZvZvZvZvZvZvZvZvZvZvZvZvZvZvZvZvZvZvZvZvZZGiXiXiXDXfAfAfAfAfAfAfAnuAcfeVzAcfeVznuvZvZvZvZvZvZvZvZvZvZvZvZvZvZvZvZvZvZvZvZvZvZvZvZvZ
vZvZvZvZvZvZvZvZvZvZvZvZvZvZvZvZvZvZvZvZvZvZvZvZvZZGiXiXiXDXfAfAfAfAfAfAfAnuAcfeVzAcfeVznuvZvZvZvZvZvZvZvZvZvZvZvZvZvZvZvZvZvZvZvZvZvZvZvZvZ
vZvZvZvZvZvZvZvZvZvZvZvZvZvZvZvZvZvZvZvZvZvZvZvZvZZGZGZGZGDXDXDXDXDXkRjAkRnununununununununuvZvZvZvZvZvZvZvZvZvZvZvZvZvZvZvZvZvZvZvZvZvZvZvZ
vZvZvZvZvZvZvZvZvZvZvZvZvZvZvZvZvZvZvZvZvZvZvZvZvZrZVeVeVeVeVeVeVeVeVeVeVeVeVeVeVeVeVeVeVerZvZvZvZvZvZvZvZvZvZvZvZvZvZvZvZvZvZvZvZvZvZvZvZvZ
vZvZvZvZvZvZvZvZvZvZvZvZvZvZvZvZvZvZvZvZvZvZvZvZvZrZVeVeVeVeVeVeVeVeVeVeVeVeVeVeVeVeVeVeVerZvZvZvZvZvZvZvZvZvZvZvZvZvZvZvZvZvZvZvZvZvZvZvZvZ
vZvZvZvZvZvZvZvZvZvZvZvZvZvZvZvZvZvZvZvZvZvZvZvZvZrZVeVeVeVeVeVeVeVeVeVeVeVeVeVeVeVeVeVeVerZvZvZvZvZvZvZvZvZvZvZvZvZvZvZvZvZvZvZvZvZvZvZvZvZ
vZvZvZvZvZvZvZvZvZvZvZvZvZvZvZvZvZvZvZvZvZvZvZvZvZrZVeVeVeVeVeVeVeVeVeVeVeVeVeVeVeVeVeVeVerZvZvZvZvZvZvZvZvZvZvZvZvZvZvZvZvZvZvZvZvZvZvZvZvZ
vZvZvZvZvZvZvZvZvZvZvZvZvZvZvZvZvZvZvZvZvZvZvZvZvZrZVeVeVeVeVerZRfRfRfbZRfRfRfrZVeVeVeVeVerZvZvZvZvZvZvZvZvZvZvZvZvZvZvZvZvZvZvZvZvZvZvZvZvZ
vZvZvZvZvZvZvZvZvZvZvZvZvZvZvZvZvZvZvZvZvZvZvZvZvZrZVeVeVeVeVerZRfWCWCWCWCWCRfrZVeVeVeVeVerZvZvZvZvZvZvZvZvZvZvZvZvZvZvZvZvZvZvZvZvZvZvZvZvZ
vZvZvZvZvZvZvZvZvZvZvZvZvZvZvZvZvZvZvZvZvZvZvZvZvZrZVeVeVerZrZrZRfWCWCWCWCWCRfrZrZrZVeVeVerZvZvZvZvZvZvZvZvZvZvZvZvZvZvZvZvZvZvZvZvZvZvZvZvZ
vZvZvZvZvZvZvZvZvZvZvZvZvZvZvZvZvZvZvZvZvZvZvZvZvZrZVeVeVerZvZvZRfRfRfJLRfRfRfvZvZrZVeVeVerZvZvZvZvZvZvZvZvZvZvZvZvZvZvZvZvZvZvZvZvZvZvZvZvZ
vZvZvZvZvZvZvZvZvZvZvZvZvZvZvZvZvZvZvZvZvZvZvZvZvZrZVeVeVerZvZvZvZvZvZvZvZvZvZvZvZrZVeVeVerZvZvZvZvZvZvZvZvZvZvZvZvZvZvZvZvZvZvZvZvZvZvZvZvZ
vZvZvZvZvZvZvZvZvZvZvZvZvZvZvZvZvZvZvZvZvZvZvZvZvZrZrZrZrZrZvZvZvZvZvZvZvZvZvZvZvZrZrZrZrZrZvZvZvZvZvZvZvZvZvZvZvZvZvZvZvZvZvZvZvZvZvZvZvZvZ
vZvZvZvZvZvZvZvZvZvZvZvZvZvZvZvZvZvZvZvZvZvZvZvZvZvZvZvZvZvZvZvZvZvZvZvZvZvZvZvZvZvZvZvZvZvZvZvZvZvZvZvZvZvZvZvZvZvZvZvZvZvZvZvZvZvZvZvZvZvZ
vZvZvZvZvZvZvZvZvZvZvZvZvZvZvZvZvZvZvZvZvZvZvZvZvZvZvZvZvZvZvZvZvZvZvZvZvZvZvZvZvZvZvZvZvZvZvZvZvZvZvZvZvZvZvZvZvZvZvZvZvZvZvZvZvZvZvZvZvZvZ
vZvZvZvZvZvZvZvZvZvZvZvZvZvZvZvZvZvZvZvZvZvZvZvZvZvZvZvZvZvZvZvZvZvZvZvZvZvZvZvZvZvZvZvZvZvZvZvZvZvZvZvZvZvZvZvZvZvZvZvZvZvZvZvZvZvZvZvZvZvZ
vZvZvZvZvZvZvZvZvZvZvZvZvZvZvZvZvZvZvZvZvZvZvZvZvZvZvZvZvZvZvZvZvZvZvZvZvZvZvZvZvZvZvZvZvZvZvZvZvZvZvZvZvZvZvZvZvZvZvZvZvZvZvZvZvZvZvZvZvZvZ
vZvZvZvZvZvZvZvZvZvZvZvZvZvZvZvZvZvZvZvZvZvZvZvZvZvZvZvZvZvZvZvZvZvZvZvZvZvZvZvZvZvZvZvZvZvZvZvZvZvZvZvZvZvZvZvZvZvZvZvZvZvZvZvZvZvZvZvZvZvZ
vZvZvZvZvZvZvZvZvZvZvZvZvZvZvZvZvZvZvZvZvZvZvZvZvZvZvZvZvZvZvZvZvZvZvZvZvZvZvZvZvZvZvZvZvZvZvZvZvZvZvZvZvZvZvZvZvZvZvZvZvZvZvZvZvZvZvZvZvZvZ
vZvZvZvZvZvZvZvZvZvZvZvZvZvZvZvZvZvZvZvZvZvZvZvZvZvZvZvZvZvZvZvZvZvZvZvZvZvZvZvZvZvZvZvZvZvZvZvZvZvZvZvZvZvZvZvZvZvZvZvZvZvZvZvZvZvZvZvZvZvZ
vZvZvZvZvZvZvZvZvZvZvZvZvZvZvZvZvZvZvZvZvZvZvZvZvZvZvZvZvZvZvZvZvZvZvZvZvZvZvZvZvZvZvZvZvZvZvZvZvZvZvZvZvZvZvZvZvZvZvZvZvZvZvZvZvZvZvZvZvZvZ
vZvZvZvZvZvZvZvZvZvZvZvZvZvZvZvZvZvZvZvZvZvZvZvZvZvZvZvZvZvZvZvZvZvZvZvZvZvZvZvZvZvZvZvZvZvZvZvZvZvZvZvZvZvZvZvZvZvZvZvZvZvZvZvZvZvZvZvZvZvZ
vZvZvZvZvZvZvZvZvZvZvZvZvZvZvZvZvZvZvZvZvZvZvZvZvZvZvZvZvZvZvZvZvZvZvZvZvZvZvZvZvZvZvZvZvZvZvZvZvZvZvZvZvZvZvZvZvZvZvZvZvZvZvZvZvZvZvZvZvZvZ
vZvZvZvZvZvZvZvZvZvZvZvZvZvZvZvZvZvZvZvZvZvZvZvZvZvZvZvZvZvZvZvZvZvZvZvZvZvZvZvZvZvZvZvZvZvZvZvZvZvZvZvZvZvZvZvZvZvZvZvZvZvZvZvZvZvZvZvZvZvZ
vZvZvZvZvZvZvZvZvZvZvZvZvZvZvZvZvZvZvZvZvZvZvZvZvZvZvZvZvZvZvZvZvZvZvZvZvZvZvZvZvZvZvZvZvZvZvZvZvZvZvZvZvZvZvZvZvZvZvZvZvZvZvZvZvZvZvZvZvZvZ
vZvZvZvZvZvZvZvZvZvZvZvZvZvZvZvZvZvZvZvZvZvZvZvZvZvZvZvZvZvZvZvZvZvZvZvZvZvZvZvZvZvZvZvZvZvZvZvZvZvZvZvZvZvZvZvZvZvZvZvZvZvZvZvZvZvZvZvZvZvZ
vZvZvZvZvZvZvZvZvZvZvZvZvZvZvZvZvZvZvZvZvZvZvZvZvZvZvZvZvZvZvZvZvZvZvZvZvZvZvZvZvZvZvZvZvZvZvZvZvZvZvZvZvZvZvZvZvZvZvZvZvZvZvZvZvZvZvZvZvZvZ
vZvZvZvZvZvZvZvZvZvZvZvZvZvZvZvZvZvZvZvZvZvZvZvZvZvZvZvZvZvZvZvZvZvZvZvZvZvZvZvZvZvZvZvZvZvZvZvZvZvZvZvZvZvZvZvZvZvZvZvZvZvZvZvZvZvZvZvZvZvZ
vZvZvZvZvZvZvZvZvZvZvZvZvZvZvZvZvZvZvZvZvZvZvZvZvZvZvZvZvZvZvZvZvZvZvZvZvZvZvZvZvZvZvZvZvZvZvZvZvZvZvZvZvZvZvZvZvZvZvZvZvZvZvZvZvZvZvZvZvZvZ
vZvZvZvZvZvZvZvZvZvZvZvZvZvZvZvZvZvZvZvZvZvZvZvZvZvZvZvZvZvZvZvZvZvZvZvZvZvZvZvZvZvZvZvZvZvZvZvZvZvZvZvZvZvZvZvZvZvZvZvZvZvZvZvZvZvZvZvZvZvZ
vZvZvZvZvZvZvZvZvZvZvZvZvZvZvZvZvZvZvZvZvZvZvZvZvZvZvZvZvZvZvZvZvZvZvZvZvZvZvZvZvZvZvZvZvZvZvZvZvZvZvZvZvZvZvZvZvZvZvZvZvZvZvZvZvZvZvZvZvZvZ
vZvZvZvZvZvZvZvZvZvZvZvZvZvZvZvZvZvZvZvZvZvZvZvZvZvZvZvZvZvZvZvZvZvZvZvZvZvZvZvZvZvZvZvZvZvZvZvZvZvZvZvZvZvZvZvZvZvZvZvZvZvZvZvZvZvZvZvZvZvZ
vZvZvZvZvZvZvZvZvZvZvZvZvZvZvZvZvZvZvZvZvZvZvZvZvZvZvZvZvZvZvZvZvZvZvZvZvZvZvZvZvZvZvZvZvZvZvZvZvZvZvZvZvZvZvZvZvZvZvZvZvZvZvZvZvZvZvZvZvZvZ
vZvZvZvZvZvZvZvZvZvZvZvZvZvZvZvZvZvZvZvZvZvZvZvZvZvZvZvZvZvZvZvZvZvZvZvZvZvZvZvZvZvZvZvZvZvZvZvZvZvZvZvZvZvZvZvZvZvZvZvZvZvZvZvZvZvZvZvZvZvZ
vZvZvZvZvZvZvZvZvZvZvZvZvZvZvZvZvZvZvZvZvZvZvZvZvZvZvZvZvZvZvZvZvZvZvZvZvZvZvZvZvZvZvZvZvZvZvZvZvZvZvZvZvZvZvZvZvZvZvZvZvZvZvZvZvZvZvZvZvZvZ
vZvZvZvZvZvZvZvZvZvZvZvZvZvZvZvZvZvZvZvZvZvZvZvZvZvZvZvZvZvZvZvZvZvZvZvZvZvZvZvZvZvZvZvZvZvZvZvZvZvZvZvZvZvZvZvZvZvZvZvZvZvZvZvZvZvZvZvZvZvZ
"}
